################################################################################################################
#                       ##                                              ##                                     #
#                 ########             ################                 ##                                     #
#                 ##                   ##          []##                 ##                      ################
#                 ##                   ##            ##           ###=####                      ##             #
#                 ########             ##        ######           ##     ##                     ##             #
#                 ##                   ##             =           ##      ##                    ##             #
#           ###################    ########=###########           ##       ##                   ##             #
#           #     ##        []#    ##                ##          ##         ##                  ##             #
#           #     ##          #    ##                ##         ##           ##                 ##             #
#           #     ##          #    ##                ##        ##             ##                ##             #
#           #     #####=#######    ##                ##       ##               ##               ##             #
#           #                 #    ##                ##      ##                ##               ##             #
#           #                 #    ##                ##      ##                ##      ###########             #
#           #                 #    ####################      ##              []##      #                       #
#           #                 #                              ####################      #                       #
#           ##########=########                                                        #                       #
#                                                                                      #                       #
#                                                                                      =                       #
#                                                                                      #                       #
################################################################################################################